5 10
5 6
0 8
0 5
6 2
4 1
  4 15 18  5 12 10 10 16 14  1
  3 25 30  2 16 16 13 22 13  2
  2 73 70  8 47 20  3 27 13  3
  4 53 65 46 34  8 17 44 51  3
  4 42 70 73 41 23 36 74 13  4
  1 35 65 13 36 62 19 77  3  5
  4 32 66 30 19 44 39 73  1  3
  1 33 77 40 26 38 42 76  2  5
  3 34 78 43 30 24 31 55 71  2
  1 30 75 42 25 14  2 17 24  7
